tilesetIso.png 7 57 114
7 7
0 1 2 3 4 5 1
1 2 3 4 5 1 0
2 3 2 5 1 0 1
3 2 5 1 0 1 2
2 5 1 0 1 2 3
5 1 0 1 2 1 1
1 0 1 2 3 4 5